test_100_6 {}

BE: nk, qW, Tu, Mu, bq, nR, Ji;
Rq: tN, gG, Wi, yg;
WM: VI, oe, VM, WH, sH, mQ, cr;
BO: Aq, Va, mQ;
WK: FQ, Tu, FA, si, sH, vy, nR, Ot, fJ;
tS: no, yg, WH, Mu, qF, cr, nR, gX;
WH: XN, ge, hA, dZ, oA;
tN: Dn, od, tk, Jd, hC, bx;
ge: oe, jI, jk, hA, po, dq;
Wi: fJ, kp, PL, vg;
gX: WM, mA, qF;
gG: XB, VI, oB, bq, Jd, EQ;
gD: Va, kp, Mq, tk, rs;
tk: nj, EK, rs, Aq, sH, Ji, yw;
Jd: Dn, nk, VM;
By: Gp, WK, Ew, hA, nR, PL;
Oo: Gw, sH, po, Yd;
qW: no, sq, Yd, OZ, hC, vy;
yg: BE, no, vg, NE, nR, hA, yw;
qF: gG, ge, nk, bq;
Ot: ib, jk;
yw: VI, rs;
dq: zo, uT, oe, oA, FA, hC, Ew, Ot;
Gw: tk, EK, no;
Gp: vy, oL, tk;
dZ: Va, rs, sq, BO, gG, BE, OZ, pD, By, Ig;
OZ: Jd, BE, qk;
qk: zo, Gp, sq, oB, Wi, nR, KX, po;
yW: mQ, tS, pD;
zo: jC;
zj: ge, EK, Wi;
rC: sq, od, dZ, jI, tk;
rs: EK, WM, oB, oA, WH, gD, pH, Ig;
zY: XN, nj, DR, FA;
PL: TK, WH;
oL: Gp, uT, WH, tk, nR, By;
Ma: BO, dZ, oB;
EK: FQ, OZ, jI;
oB: zo, NE, Mu, pH, KX, DR, Ig;
oA: nj, zo, Gp, NE, tN, dZ, OZ;
Mu: XB, yg, Aq, mQ, tk, qF, nR, TK;
Mq: FQ, XB, WK, oA, Mu, mQ, Ot;
bq: Oo, FQ, nj, Rq, oB, si, gD, Jd, bx, yW;
jk: sq, tS, IO;
bx: uT, DR, zj, Mq;
hA: Gp, VI, WM, WH, Mq, jI, dZ, yW;
oe: ib, bq, yg, KX;
od: jI, oA, vg;
jI: Dn, WK, PL, Mq, bq, Ib, yw;
Ew: Va, Ib, BO, sH, tN, kp, gD, mQ, hA;
Ep: oL, Mq, ik, gX, ge, nk, mQ, hC, pH;
jC: oL, bx, zj, gX;
FQ: Oo, nk, qW, oB, Aq, jI, cr, vy, hA;
FA: Gw, rs, VI, WH, kp, bq, Ot, EQ, po, yW;
pD: XB, mA, Mq, tk, Ji;
cr: oe, nj, rC;
pH: jC, Rq, NE, zj, po;
EQ: pH, NE;
NE: Dn, BE, oL, Ma, qW, oe, WK, Mq, tk, OZ;
po: oe, tS, Aq, FA, sH, tk;
Ji: qW, uT, oB, tN, tk, jk, hC, By;
mA: BE, zo, Gp, Tu, VM, yg, si, no, Ew;
XB: Aq, ik, sH, Ma, oB;
uT: si, EQ;
mQ: mA, XB, Mu, dZ, bq, XN, Ib, By;
hC: qW, EK, uT, WM, gD, vy, By, dq;
KX: tS, oA, ik, bq, Jd, nR, By, yw, Ji;
vg: pH, EQ;
Tu: zY, VM, yW, PL;
ik: Oo, Ma, od, si, jI, cr, pH, yW;
vy: Jd, tN, gD, VM, Gp;
XN: Ma, BO, Aq, mQ, tk, cr, qk, jC;
nR: nj, XN, rs, ik, tk, Ig;
ib: oL, zj, EK, VI, BO, WH, kp, jk, hA, EQ;
DR: Ma, oe, Aq, Jd, XN, Ep, jC;
Dn: WM, yW, pD, tS;
nj: oL, Gp, no, Wi, IO, Ew, hA, EQ;
nk: jI, VM, Aq, dZ, TK, bq;
no: Dn, oe, Yd, gG, ik, Ew;
Yd: cr, ge, Ig, Gp;
TK: vg, Rq, rs, BO, PL, yW, Ig;
VI: BE, rs, mQ, zY, hA, bx;
VM: Gp, yg, FA, qF, hC, Ot, dq;
sH: VI, yg;
IO: VI, oe, jI, VM;
Va: zo, oe, VM, ik, Ji, vy, nR, jI;
sq: jC, dq, rC, no;
Aq: no, tS, dZ, OZ, rC, yW;
si: Dn, mA, gD, dZ, tk, qF, cr;
kp: BE, od;
fJ: DR, Ep, zj;
Ib: mQ, Wi;
Ig: FQ, Ma, tS, NE, qk, po;