test_100_1 {}

JV: Ys, HX, Xa, Ri, KT;
gz: AX, JV;
gf: Ia, eL, Wt, xw;
WU: iX, HX, JV, Xa, rZ, yY, ZX, Wr;
tI: tA, OY, fG;
Ri: CC, co, Ln, Lo, HV, gf, So, dT, pl;
gh: dc, gf, bp, qJ, xw, eS, tA;
Wg: yY, mU;
Bf: vU, Zj;
gQ: gf, WU, DJ, Id, vU;
Ju: mu, Bf, CO, Qw, Mr;
Wt: Em, aq, dJ, Ef, II, in, tI, oQ;
Jh: uT, HV, Wr, tI, OT, Id;
Wr: zu, NA, Ol, Mr;
Wp: Ol, Ik, mu, Si, So, DP, KT, ZX, OT, eS;
Ol: gQ, gz, Wt, Wp, AX, qJ, qo;
dc: gQ, jV, Xa, fG, aZ, Id;
qJ: Wg, Yp, hQ, bp, qo;
dp: CC, IS, ev;
qs: hQ, KT;
dJ: Wg, HX, gQ, jV, dc, yY, jj, ev;
tL: Ln, qs, ev, sO, tA;
yY: co, Zj, VR, Ik, So, DJ, Nr, aZ, tA;
OY: II, zu, ZX, Wr;
dT: dJ, Qw, XA, HV, Nr, OT;
OT: Ol, gQ, Jz, jV, mu, bp, TH, Wp, qo, gh;
qo: eL, Ol, Ju, dc, yY, WU, rm, aZ;
HX: Nr, Wt, HV, DP, Zj;
Xa: QX, Yp, co, xw, AX;
JK: qs, OY, sq, sO, jj, zu;
HV: Ju, Ef, sO, jj;
rZ: CO, HX, dJ, FU;
HB: AX, Ef, rZ, Wa, hQ;
zu: Qw, Ju, Xa, mU, gf, vU, jj, Nr, Id, qo;
ev: sq, XA, tI, zu, dT, OT;
eL: DJ, sq, dc, yY, tL, TH, dJ;
rm: qs, ai, Ju, HX, tL, dT, OT, Id, eS;
tA: Em, OT, jj, gQ, jV, JK, rZ, TH, fG, aZ;
eS: sO, VR, aZ, dJ;
bp: gQ, Jz, Lo, IS, fG, OY, in, FU;
jj: II, yY, Nr, sO, Ik;
Mr: Jz, fG, HV, mU, Jh, JK, qJ, Ri;
Wa: aq, CO, gQ, yY, Wt, So, jj, pl;
oQ: Ol, KT, yY, ZX, in, OT, xw;
Em: sq, DJ, Qw, DP, TH;
Jz: WU, ev, gh;
Zj: ak, dc, Wt, So, vU, TH, KT, Ia, oQ;
jV: co, Xa, yY, HB, VR, Mr, Ia, Nr;
Ef: Ol, Qm;
ZX: rm, hQ, Qm, TH, tA;
ou: co, Yo, CC, Ju, HV, Si, WU, JK, FH, CO;
co: HX, ev, gQ, mU, Si, Ar, bp, Ia, qJ, eS;
FU: DJ, gQ, CC, IS, HV, mU, Yp, OT, oQ;
FH: WU, Qm, TH, Wa;
Nr: Bf, XA, TH, in, FH, Mr, ou, OT, pl;
xw: sq, Mr;
NA: ai, Ju, gQ, Zj;
Ln: HX, ai, JV, sO, TH, Wp, So, dT, qJ, Jh;
pl: hQ, Jz, Wa, XA, mU, jj, qJ;
CO: Wg, DJ, Zj, ak, bp, co, DP;
CC: Em, aY, Ju, uT;
uT: gf, CO, iX, jj, tA;
XA: co, gQ, ai, Ju, gz, dJ, ev;
mU: sq, qJ, ZX;
Si: Em, gf, aZ, ev;
So: HX, HV, Bf, mu, Yp, Ys, aZ, dT, gh;
hQ: Zj, ou, Jh, Ri, Yo;
mu: gQ, ak, mU, Jh, JK, Ia, ou, Ri;
KT: Ol, TH, Wp;
DJ: Jz, uT, mU, Si, JK, Ri, pl;
ai: Em, FU, Zj, Ln, Ik, tI, rm, qJ, eS;
Lo: DJ, FU, gh;
ak: iX, eL, Ln, sO, TH, JK, Ys, pl;
aq: pl, jj, in;
in: zu, eL, dc, TH, iX;
DP: mU, VR, JV, Ri, in;
iX: Jh, dp;
Yo: qJ, vU, Ri;
vU: II, CO, CC, QX, sq, Ef, HV, mU, Mr;
TH: Wg, eL, Bf, Ln, Wt, Jh, dT, OT, tA;
aY: sq, jj;
Yp: Em, Ik, FU, Ri, gh;
Ys: Em, co, Ju, Ik, jj, Mr, Ia, qo;
aZ: eL, Ln, NA, mu, CC, VR, AX, ou;
Qw: Ju, qs, CO, oQ;
IS: aq, tI, Wr, Qw, tA;
II: qs, FU, CC, tL, Wr, JK, zu, gh;
VR: mU, TH, Wr, Jz, tA;
sO: Wg, co, II, Si, ZX, pl, dp;
AX: Si, eS, Zj;
Qm: Yo, mU, WU, TH, Ia, zu, qJ;
QX: Wg, Ju, iX, Wp;
sq: eL, co, ZX, Qw;
Ik: Ln, ZX, DP, zu, ou, dT, eS;
Ar: mU, Jh;
fG: Yo, Jz, NA, hQ, gz, mU, Mr;
Ia: Ef, ev, vU, gh;
Id: HX, co, Ef, sO, Wr, So, qJ;