test_100_2 {}

WD: mE, rU, Rs, vQ, Si, xy, Dp, xu;
WB: WD, kG, Yl, bL, xC, uN, FE, Zu, az, yW;
BC: bL, Bv, xu, xy, tA;
gy: Ca, AJ, eY, Lp, qf, tA;
tA: QE, ez;
Wo: cO, Ut, jv, cy, bq, Th, Dp;
Rs: dt, EF, kG, es;
Bv: BC, FE, ez, Zu, nr, fK, Dp;
PF: Iz, TZ, Qt, iL, ku, YS;
tb: az, Qt, wD;
dm: WD, mc, AJ;
dt: wD, Wo, xC, iD, HI, FE, NU, Dp;
nr: NA, KO, tA;
Du: vr, es;
dZ: jN, BC, Du, OP;
qf: vB, iB, mc, Ut, Bv, Du, Tb;
OR: lm, Ux, ku, Xw;
yW: jN, MW, Si, kV, FL;
OP: rU, oE, Qt, Qo, BC;
rU: bq, Zu, jN, dt, Rs;
HI: Bv, bG, PF;
ez: mE, kG, AJ, xy, dt, es;
es: PF, dZ, OR, US, qf;
eY: FQ, cO, Qw, Ca, uN, QE, bq, Zu;
oE: Zn, TZ, tb, lm, MW, iL, YS, Tb;
Ux: kG, ku;
Ut: vA, uN, FL;
jv: FQ, Qw, Fw, Wo, Rs, Bv, iB;
EF: WB, Qw, bL, YE, NU, PF, lz, mx, Ux;
bq: bL, Wo, Vj, cy;
Zn: vB, cO, Ux, mc, Rs, Vj, MW, fK, mx, Qo;
bG: Rs, US, vQ, tA, es, xu;
bL: az, iB, Dp, Iz;
US: oE, jN, qf, FL, NU, tA;
Xw: Ks, mE, US, Lp;
jN: Ut, vQ, xy, PF, Ah, iD, Dp;
NA: AJ, FL, bq, OR;
Zu: MW, YE, YS;
FQ: mE, Ah, Iz;
lm: vQ, xX, bq, yW;
cy: jN, uN, kG, bG;
xy: mE, Zn, iL;
FE: vA, wD, FQ, Tb, jv, lm, tb, xu;
FL: WD, WB, oE, US, bG, jv;
xu: bG, kG, Vj, KO, xX, uN, qf, nr, az, fK;
cO: TZ, Vj, Si, eY, kV, QE, nr, tb, Dp;
Fw: vA, Zn, Th, xC, QE, Lp, nr, Du, Qo;
xC: Si, mx, Rs;
xX: vg, Wo, NU, Ks, cy, so, FL, iD;
NU: vA, Zn, cO, WB, cy, US, MW, xy, so, ku;
mE: Vj, cy, vQ, jN, Zu, iD;
Ks: tb, Lp;
Si: rU, dm, TZ, BC, lm, MW, eY, dZ, TD;
uN: FQ, xC, Ca, xX, Bv, eY, NA, fK, OP;
Se: TD, nr, Lp;
Ch: tb, iL;
mc: vA, AJ, Ah, EF, Bv, vs, dt, Tb, xu;
lz: Ch, BC, bL, so, bq, iD;
Ca: PF, jN, QE, aU, TD;
KO: cO, ku, Ah, EF, jN, HI, Lp;
mx: vg, Wo, cy, PF, Qo, QE, yW;
Th: rU, dm, NA, AJ, YE, vs, dZ, dt, fK;
vg: FL, lz, Lp, US, Rs;
YE: Ks, Si, es;
vr: Wo, Zu, jN, US, xu;
vs: Ch, Qw, vg, FL, Tb, cy, ez, lz, yW;
Lp: bG, kG, BC, xC, Ks, vr, qf, xu, es, OP;
YS: Wo, xC, HI;
az: dm, Rs, oE, QE, FE, ku, ez, FL, Xw;
Tb: Wo, FQ, Th;
vA: vB, AJ;
vB: WB, Qw, xy, eY, dZ, nr, aU;
TZ: jv, xy, YE, FE;
Yl: QE, Se;
MW: rU, kG, cy, Si, HI, dZ, fK, Se;
vQ: vg, iD, uN, Lp, qf, az, OR, Se;
aU: lm, xC, AJ, KO, Si, MW, iL, Lp, iB;
iL: NA, xX, fK, Vj, Fw;
so: Ks, uN, lm, iD, bG;
TD: Ux, cy, HI, Zu, fK, FL;
iB: fK, TZ, FE, EF;
iD: iB, Zn, bG, jv, yW;
Dp: mE, wD, Rs, xX, uN, iL, OP, iB, kV;
kG: Ah, fK, Fw, kV, NA;
Qt: Yl, Fw, Ut, Vj, US, cy, Lp, NA, es;
Qw: Ca;
wD: mE, Vj, Dp;
AJ: TZ, xC, oE, Ks, Bv, HI, PF, QE, iD, xu;
kV: nr, mx, OP;
Qo: Ch, jv, MW, bG, iL, YS, bq;
Iz: dm, Qw, vg, oE, AJ, gy, Th, dt, Xw, Qo;
Ah: FQ, xX, PF, kV, Se;
Vj: WD, Rs, Ah, cy, Bv, uN, eY;
QE: mE, Yl, xX, iL, dt, Qo;
ku: dm, Tb, Xw, gy, OR;
fK: TZ, Iz, cO, Qo;