test_100_3 {}

BF: dN, en, SU, YF, OY, qk, eb, Xv, cu, mz;
BV: wn, BF, mR;
Wa: Xv, SV, GY, lp, Lz, DP, fo;
lh: Pk, Oi;
Wv: Zn, GS, Pt, KJ, lh, Ws, Pk, fK, Os;
Ws: GS, mB, ip, iu, SV, rh, DP;
lp: ZM, Nm, KJ, mR, SV, oa, iJ, SM, oX, ID;
gK: en, lh, SU, hB, Vy, ph, Xv, wz, cu;
GS: wm, GY, Ej;
Oi: PS, BF, en, wn, Yj, iJ, lp, XS, MY;
GY: qK, Xv, Ms;
qK: GS, Oi, mB, ee, XX, mR, DP;
Os: MY, Tb, ML;
ds: yJ, HS, SU, XX, hB, Vy;
dN: Zn, CH, sK, en, OY, wz, cu;
yJ: dN, ZM, Nm, XS, MY, DP;
OY: PS, jx, mB, GY, BV, MA, ph, NU;
qk: jx, Pk, Xv, MY, ID;
yR: en, Xm, nU, ju, mB, XG, eb, SM, wz;
en: fP, Ci, CH, Oi, Xm, hB, Vy, Lz, DP;
Pt: en, eI, af, Tb, iu, KM, Wv, MY;
ee: yJ, gK, ds, mB;
HS: Tz, cL, Xv, YF, kp, Ws, Na, eI, rh, NU;
eb: ZM, XX, Wa, mz;
SU: qK, DP;
Pk: ZM, GS, Oi, Na, XX, ML, yR;
PS: iy, Pt, cL, YF, aq, YQ, qK, DP;
eI: ip, ph, iJ, cL;
Hv: Wa, KJ, Ws, qK, cp, nU;
ju: wm, Xv, XG;
rh: dN, Oi, ee, HS, Ms, Tb, fo;
ZM: An, Yj, oX;
jx: PS, Oi, ip, wm, aq, Xv;
wn: PS, An, jx, SV, bX;
wm: HS, Na, vr, ju, qk, Tb, fo;
Ms: ix, Yj, KJ, CH, Al, YF, XX, yJ, SV, fK;
oX: HS, cp, jx;
wz: iy, Ci, HS, wm, XG, YQ, MY;
Zn: Ej, ML, mR, Al, SU, oa, HS;
MA: af, wn, wm, XG, GY, YF, SM, ML, qk;
Ej: jx, Wa, KM, XS, fK, ds;
ML: fP, Zn, Wa, MY, wm, vr, kp, Os, wz;
oa: YQ, Xv, wm, iu, Xm;
MY: dN, BF, Xm, Os, wm, SV, Tb, NU;
Nm: YF, Tb, Wa, Ms, Xm;
Na: ee, wz, Wa, Ej;
cp: BF, Na, iu, iJ, Ws, YQ, Xv;
cu: Ws, Lz, Wa, Ej;
cL: PS, Vy, jx, XS, hB, Pk;
ph: GS, Wa, wn, sK, SM, YQ, MY;
NU: ju, iJ, XG, Wa, mB;
CH: Zn, Tz, Nm, Wa, KJ, Hv, sK, Na, hB, rh;
mC: en, GS, Nm, BV, SV, oa, vr, cp, gK, Yw;
mB: ZM, GS, Pt, wm, YF, hB, An, gK, cu;
XG: Ci, Oi, ip, SU, XX, MY, Sg, ds;
XX: sK, Zn, wm, mR;
mR: XS, LS;
XS: YQ, ju, wm, mz;
Sg: iy, oa, Zn, mB, XG, KM, BV, SU, hB, Lz;
Ci: sK, wn, fK, ds, YF;
Xm: aq, BV, yJ, LS, YF;
KJ: ip, Hv, ID, XS, Lz, ds;
SV: en, Xv, lp, Ms;
KM: BF, mC, SU, aq, kp, GY, ID;
SM: fP, Ci, Pt, cL, XS, Vy, Pk, Os;
hB: iy, yJ, MA, iJ, NU;
Xv: ju, mR, Al, Ms, SM;
mz: en, Sg, eb, aq, Vy, qk, Tb, ph;
iy: KJ, ph;
ix: GS, ju, wm, vr, OY, gK;
Tz: MA, Na, GY, An, ML, Sg, gK, Yw;
af: cL, ee, GY, eb, aq, kp, YQ, ph, bX;
ip: Yj, jx, Na, yR, Lz, cu;
iu: HS, Pt;
YF: iy, ph, Al, BF;
aq: mB, ee, ju, Hv, LS, yR;
vr: ee, Ws, en, MY, ip;
YQ: KJ, An, lp, mR, cp, NU;
Tb: fP, Nm, Oi, HS, Ms, Wa, Yw;
nU: PS, MA, wn, Tb, KM, HS, Tz, Os, ID;
DP: rh, GS, Oi, KJ, Yw, Ms, Na, fK, Sg, cu;
Yj: Xv, ee, gK, Tb, Wv, oX, Pk, bX, wz;
Lz: ZM, BF, Nm, mC, Oi, fK;
iJ: Hv, SU, Ws, qK, Tb, wz;
LS: Tz, mB, ee, Na, iu, kp, HS, eI, fo;
Yw: Pk, yR, ds, Pt, cL;
sK: fP, Wa, af, ML, XG, BV, cp;
ID: GS, mB, sK, oX, ph, Sg;
fo: fP, ju, iJ, XG, cu;
fP: ee, MA, XG;
bX: iy, Na, wm;
Al: ZM, en, mC, KJ, YF, aq, lp, fK, DP;
An: dN, Zn, GS, wm, XS, Vy, qk, Yw;
kp: BF, Ej, ee, Na, An, Wv, lp, wz;
Vy: sK, Tz, iu, jx, af;
fK: iy, Nm, Pt, ip, XG, eb, hB, Sg, wz;