test_100_0 {}

lB: el, en, ba;
lK: Oi, LY, CX, Ir, gY, cx, mp, jg, xU;
tP: wU, so, nu;
lI: zL, Fx, jQ, wU, UN, uI, rb, ID;
WT: OV, od, tP;
lS: Di, nC, wj, lK, cx, os;
go: Wl, wj, vp, cx, os, cu;
JE: Mw, IK;
qW: go, OV, IK, AZ, oq;
Wg: em, HP, SU, cx, dZ, Bq, JE, qH;
Jy: vp, Vq, ll, Wl, xU;
ll: eK, VX, CX, uI, mp, qI, Fh;
Wl: Dk, HM;
gY: Dk, pU, mU, Ar, go, AZ, os;
Bu: zL, Es, en, pU, dZ, mp, rb, Rl, AZ, oq;
gC: el, Jy, Oi, lK, WT, VX, PM, xU;
Bq: SZ, rO;
Oi: HP, HV, Lv, mp, UB, xw, PM;
GF: mU, zd;
qI: ll, gY, vp, JE, UW, UB;
qH: VX, UW;
yJ: FY, GF, Ar, dZ, Bq, OV, AZ, PM;
dC: lB, Iv;
dZ: yJ, ba, FY, tP, Rl, LT, go, jg, nu, UB;
OV: en, Jy, Es, xw;
dQ: qI, Ud, em, Wl, SZ;
em: Vq, qW, oq, xU;
el: Fx, Ud, Wl, GF, wU, EY, OV, JE;
en: wU, nC, xw, lK;
zd: Vq, cx, tP, Es;
HP: PS, Sn;
HV: KK, UB, lI, Bu, LT, qH, PI, cu, LY;
Rl: em, Wg, rb;
HM: od, HP, nC, Iv, CX, rb, qH, ll;
rO: bd, Ir, en;
zL: Fx, qH, Ar;
PS: Vq, CN, tP;
eK: zL, Ir, dC, SU, CX, gY, HM, Sn;
eB: pU, wU, ll, wj, mU, LT, cu, LY;
rb: ba, ll, KN, mU, Vq, EY, Ud;
PI: rO, od, IK, HM, jg, dQ;
PM: ba, pU, zd, SU, Bu, Fh, Ud, UB;
bd: Wl, jQ, mU, cx, LY, xw, xU;
ba: ni, eK, VX, EY, Bq, jk, Rl, Ud;
wj: yJ, HV, mU, en, qI, xw;
Mw: Ud, LT, jg, lB, rb;
EY: Wl, jg, PI, Oi, ba;
jk: Lv, go;
Ud: Jy, Oi, LT, WT, gC, lS, go;
jg: em, Dk, dC, tP, Vq, Ar, mp, os;
vp: yJ, qW, eK, ll, WT, OV, UB;
ML: Wg, SZ, jP, Mw, VX, Es, LY;
UW: Bu, Mw, KN, lS, Di;
od: ni, AZ, ba, Lv, jg, PI, Es, UB;
jP: yJ, ba, eK, FY, mU, mp, PI, CN;
jQ: fX, GF, cx, Oi, HM;
wU: zL, Ir, lB, Wl, jQ, GF, Ar;
UN: Wl, Ir, Vq, yJ, dZ, rb, qI, gC, Es;
os: qI, PS, EY;
Es: VX, yJ, jP;
UB: Jy, FY, od, jP, IK, Rl, AZ;
pU: Fh, ML, od, so, Di;
FY: JE, HV, CN;
cx: Wg, en, Oi, fX, lI, Vq, jk, Es, LY;
xw: Fx, Rl;
cu: SZ, Oi, pU, ll, Rl, xU;
Fx: CN, tP, vp, Mw, so, nu;
Fh: bd, lB, Sn, rb, jk, Rl;
xU: LY, dQ;
CN: OV, HP, yJ, wj, Vq;
mU: Wg, Bq;
CX: WT, Mw, yJ, Ar;
uI: GF, od, dQ;
Sn: FY, Ir, lK, Bq, JE, LY;
SZ: mp, SU;
KK: PS, Oi, Fx, UW, HV, Mw, gC, PI;
KN: vp, Di, zd, lK, Lv, WT, lS, el, JE, AZ;
SU: pU, zd, wj, tP, Fx, cx, Rl, qH, ID, dQ;
mp: od, ba, nC, lK, Sn, Ud, Jy;
nC: FY, dZ;
Lv: qW, Oi, tP, wU, cx, gC, rb, UN, LY;
ni: oq, CN, mp, OV, PI, cu;
Dk: ba, od, lK, eB, CX, jk;
Di: el, Ir, UN, Sn, jk, go;
LT: ba, Oi, zd, Iv, KK, AZ;
nu: CX, Lv, IK, cx, dZ, LY;
LY: qI, tP;
IK: zL, rO, ML, SU, WT, uI, so, PM, xw, UB;
VX: Ir, ba, Wl, jQ, rb, HM, Ud, Jy;
AZ: eK, zd, eB, Fx, Mw, Rl, xw, cu;
ID: Rl, SZ, eK, xU;
fX: el, Jy, Oi, ML, HP, wj, CX, lS, JE;
Ir: el, wU, os;
Iv: qI, jP, Jy, SU, Di;
Vq: em, el, ba, Di, fX, mU, WT;
Ar: PS, en, lB, Wl, wU, os, LY;
so: lK, Iv;
oq: em, qW, gY, cx, jk, VX, ID, LY;