test_100_5 {}

Ss: lw, Qs, fC, FD;
Ru: Kq, hV;
lC: YH, Md, Pz, Vj, OX, as, dz, Jk;
JP: YH, xH, Gs, VF, yH, VL, bU, wU, Wx;
WI: ey, Oi, Lx, OX;
JJ: Wx, ey, SD;
lX: Ch, dy, Wx;
gV: Kq, eA;
lw: og, vL, eA, OS, Ty;
Jk: Qs, FD, fj;
Wx: bU, SV;
Oi: Fb, lC;
Og: Tk, lX;
yc: Xc, YC, vL, as, JJ, uj, lX;
GG: Kq, hy, Ej;
dz: og, bj;
dy: yH, ey, Gs, Uz;
yH: YH, CL, Ss, aP, YC, hV, bj, lw, kP, HG;
Gs: yH, YH, Og, VJ, JP, Dc, vN, fC, Md;
Xl: lC, og, nc, hV, ii, Pz, XX, ey, Jk;
OE: Kc, Md, Lj, eA, Lx;
OX: YH, nT, lX, bj, Uz;
OS: og, FF, Wx;
CL: Ss, oG, Og, bU, JJ, zV, SD;
Pz: Ru, nc, FD, Ty;
ey: Ru, YC, VL, lC;
rO: aQ, Qs, CL;
HG: Gs, fU, Lj, vL, oB, ii, Fb, nT;
zM: oG, of, YC, zG, Ss, XX, dz, Zu, HG;
zG: Og, eA, Gs, hV, OX;
eA: xH, Ch, Og, yc, nc, ii, kP, uj;
zV: DF, VL, ii, HG, ES, SD;
Md: og, as;
Uz: of, Vj, ey, bU;
oG: VJ, rO, zV, jJ, sV;
oB: aP, nc, bU, wU, pG, Zu, XT;
bj: Zu, FD;
bi: hy, Ty, Og, eA, nc, Lj, jJ, Zu;
ES: VJ, rO, bj;
Ub: bi, JP, oB, bj, fU;
Ej: uj, sV, vN, ey, pG, dy, DT, nT, lX;
og: rO, Lj;
of: bi, SV, Dc, kP, Jk, rO;
bU: Qs, Qr, Ty, og, Xc, mB, JP, bi;
wU: mB, zV, kP, Ej;
jJ: zM, Qr, Ty, of, Vj, ii, dy, nT, ES;
Zu: Ej, Pz, sV, ey, zV, Wx;
xf: Wx, nT, jJ, Ty;
FD: Ru, Ch, VL, eA, GG, bU, pG, zV, hV;
pG: Xl, Ej, VL, as, GG, Fb, jJ, NU;
FF: xf, Pz, Xc, nc, Lj, bi, GG, wU, NU;
xH: Ru, lX;
Fb: Md, Qr, of, Vj, hV, bi, bj, sa;
NU: ES, Uz;
Kc: as, vL;
hy: Kc, vD, KE, VJ, oB, fC, fj, Ub;
mB: sV, aP, ey, dy, dz, lX, SD;
uU: Zu, xH, Ru, ES, zM;
XX: xf, NU;
XT: Ru, Md, JP, aQ, fC, SD, Wx, Ub;
Ch: og, yc, Ub;
KE: fU, of, xf, oB, Kq, jJ, JJ, Ub;
Xc: VJ, eA, OX;
hV: Ru, mB, og, of, VJ, JP, ii, DT, nT;
SV: Kc, WI, aQ, bU, jJ, Vz, nT;
KP: hV, Xl;
uj: Zu, FD, Gs, Ru;
SD: Kc, Md, Fb, dz, jJ, lX, Wx;
YH: gV, Qr, Gs, Vj, Dc, FD;
Ty: VF, Pz, SV, as, dz, Tk, XT;
DF: hy, Oi, CL, of, OX, wU, Tk, Xc;
YC: DF, vL, aP, wU, dz, OX, NU;
Lj: hy, Oi, CL;
ii: KE, OE, VL, vN, wU, HG, SD;
as: Qr, Xl, of, vL, Ch, JJ, Vz, Lx;
Tk: gV, mB, oG, VL, lw, Fb, Ru, zV, XT;
DT: lw, Vz, KP, vN, Wx;
nT: Qs, Qr, xf, yc, VL, aQ, Fb, jJ, Vz;
Lx: dz, VL, sV, KE;
vD: Kc, Oi;
nc: Qr, Uz, DF, VJ, WI, oG, NU;
vL: Fb, Ch, hV, KE, bj;
Dc: Vj, Qr, VL, WI;
vN: Xc, wU, nT, SV, NU;
aQ: gV, vD, Vj, xf, XX, Zu, zV, yc, lX;
aP: yH, Qr, gV, uj, WI, ii, bU, dz, dy, lX;
Qs: KE, Ru, ES, bj, bU;
Qr: VF, eA, nc, VL, Kq, Jk, Zu, OX;
VF: Ru, zM, XX, JJ, zV, OS, Vz, Lx, Wx;
VJ: ii, Vz, kP, Fb, fU;
VL: aP, XX, Ch, VF, OX;
sV: Kc, zV, Ej;
kP: of, Gs, SV, gV;
fj: gV, OE, Dc, GG, aP, Kq, as, Lx;
Vz: Og, Ss, NU, Dc;
fU: Vj, Ch, SD;
Vj: DF, vL, OX, hV, WI, Xc, ii, lw, dy;
Kq: Kc, FF, JJ;
fC: kP, vN;
sa: fj, KE, Ej;