test_100_7 {}

tZ: NL, ok, wK, lh, wh, hh, gb, kz;
BA: hx, JT, wK, dZ, lQ, kz, Kx;
JT: AS, kn;
BM: JT, wK, Ko, Up, Ff, AV;
JH: Ll, Jr, Gy, nN, LA;
gb: HI, lh, Jr;
lQ: BA, nN, mb, La, lh, AS;
Jy: co, KJ, kn, Pd, AV, gM;
Jr: wC, AS, Gy, hh, Ue, kz, gM;
tq: fs, LB, Ej, MM, SU, AN, vv, AV;
tl: dv, Qh, yo, Jr;
gM: MG, En, yo, BM, Ca, oD, LE, Ff, AV;
yo: dv, qZ, La;
qZ: wC, MM, KJ, Pb, pz, dZ, KV, vv, OV;
yx: tl, gM, Dt, er;
dx: LE, NL, Jy, KJ, wh, dv, SE, BA;
dv: Pb, ph, HI, LB, io;
Gy: hx, Ek, Xa, wh, AS, ph;
dZ: Ff, kn, Gy;
OV: LE, QT, VK, Ko, Pb, dx, Kx;
OQ: MG, mx, AN;
HX: Ll, QT, yo, OQ;
Pv: En, ok, JT, BM, wK, wh, LE, DU, OQ;
Pb: Xi, pv, Ej, fs, aU, gb, co;
HI: ba, nN, JT, oD, kn, Jr, mz, mx, Jy;
Pd: hx, ok;
er: Pv, LE, wC, LA, La, Xa, Pb, tl, tZ;
oN: Pb, JH;
ba: BM, HX, LE, wC, Pd;
oD: wG, ok, MM, Ll, tl, gb, mz;
Up: MG, fs, Pv, Ek, yo, mb, pz, KJ, oD, aU;
wh: ph, HI, io, Gy, mb;
Ue: IK, Up, mz;
NL: qZ, Pv, mx, Ek, AN;
bx: JT, kn, wh;
wG: MG, La, CC, BM, oD, Up, wh, Pb, tl, er;
MG: IK, AN;
En: wG, KJ, Ll, Ca, CD;
ok: MG, Jy, Ef, vv, sb, bx, OQ;
Ek: HX, Xi, pv, NL, co, ph, mx;
Ej: oN, hx, Jy, BM, qZ, lh, IJ, JH, lQ, OV;
MM: nN, JT, oD, lh, AS, Aw;
Ef: wC, Xa, Ko, dZ, io, Qh, DU, mx;
wK: kz, En, ok, Ff;
IK: HX, co, HI, aU, io, lQ, dv, Kx;
xk: Ca, AV;
co: aa, pv, AN;
lh: wK, CD, Pb, gb, Pd, OV, gM, Dt;
Nw: lQ, Xa, Pv, mb;
pv: Xa, Ll, Kx, Ko, QT;
pz: LE, OQ;
NG: lQ, Nw, LE, La;
Ff: HX, Xi, BA, oD, yx, Qh;
ph: VK, mb, pz, KJ, qZ, kn, Aw, Dt;
hx: wG, HX, NL, ba, JT, Gy, wh, gb, Nw;
uX: wG, qZ, Pd;
CC: aa, DU, vv;
Ko: wG, xk, hx, Pv, oD, yx, Pd, sb, mz;
mH: tZ, nN, Ll, Pb, lQ, er;
CD: tq, KV, Jr, AN;
hh: wG, VK, Pv, wC, oD, qZ, tq, sb;
wC: xk, pv, CC, KJ, wh, Aw, OV, Kx, mx, er;
Kx: yx, IJ, bx, nN;
Xi: wG, co, uX, Ej, lh, AS, gb, er;
mb: QT, wh;
KJ: pv, mb, CC, Ll, kn, Gy, dZ, Nw;
Ca: ok, uX, VK, lh, CD, Jr, DU;
Xa: Ef, mH;
SU: BM, hh, lh, Gy, lQ;
KV: wG, Dt, VK, gb, OQ;
mx: io, er;
SE: NL, nN, LA, JT, tq, Ff, Ue, mz;
mz: Jy, AN;
aa: fs, co, JT, tq, Pd, AV;
sb: CD, KV, dx, Ej;
vv: hx, LE, NL, Ca, Jr, hh, KV, OV, gM;
nN: LE, CC, qZ, Ko, DU, JT, vv, Kx, bx;
La: Xi, NG;
Ll: NL, vv, Ej, wK, mH, Jr, KV, io, dx, mx;
io: oN, QT, yo, mb, Ll, Jr, Ek, aU, dv;
DU: aa, MM, aU, AN;
LE: QT, wK, tq, dZ, gb, JH, er, uX;
LB: wC, Xa, co, dx, lh;
LA: dZ, CC, mH, yx, aU, Aw, AV, Qh, mx;
aU: Pb, wK, AN;
Dt: MM, Up, Gy, tq, aU, SE;
fs: co, er;
VK: aa, LB, mb, JT, kn, SU;
AN: kz, gM, BA, lQ;
AS: kz, En, SU, dx, Aw;
IJ: BM, ok;
AV: MG, QT, KJ, Ll, IJ, CD, HI, lh, dx, BM;
Qh: JH, tq;
QT: ok, nN, Xa, mH, wh, yx, hh, kz, ph, er;
kn: co, BA;
Aw: yx, tl, NL, Gy;
kz: Pb, BM, CC, gb;