test_100_9 {}

WB: DN, zj, qv, na, bS, Ti, ti, sB, iE, SF;
lN: Jv, bh;
gg: NJ, Xa, Oz, qb, Ti;
JM: Zx, th;
tK: PJ, Zu, qb, NL;
tD: PJ, aL;
gT: zj, TP, xe, JM, YQ, dT;
Jv: oJ, KS, hH, GA, bS, fh;
Bk: rQ, CB, bh, DC, YW, oJ;
Jh: DL, HY, UP, JM, PJ, dT, YW;
th: yk, CB, DE, bh, aL, xe, LR, ti, he;
ti: gT, HY, XT, dO;
yk: ed, Ti;
Oh: re, uK, fh, ug, YW, fo;
yz: NJ, HY, Ss, re, tK, Ti, tD, ug, XT, NW;
Oz: he, Oh;
GA: gT, NL, qb, Ti, fh, sB, ou;
dO: Dn, SF, LU, id, fe;
qv: DN, Xa, LR, Oz, Ti, ou, Xw, pL;
Gf: dO, Ym, WB, DC, xe, vQ, tK, bS, sB, sF;
qb: WB, Af, Xw, Gf, wQ, id, YW;
Om: Dn, rQ, na, hH, uK, dT, pL;
dT: oJ, zj, re, Zd, vQ, PJ, hf, SF;
rU: aL, YW;
HY: Yy, Zd;
rQ: hx, DC, id, ug, iE, sF, NW;
zj: dO, yk, kf, JM, lN, xe, Gf, LU, he;
ed: uM, YQ, CB, XT, Oh;
zI: fh, lN, Zd;
re: rU, NL, zI, Ss, Yy, SJ, Jh, uK;
PJ: KS, rU, Zd, Yg, uM, Ss, SO, mp, XT, Oz;
oJ: NJ, DE, DC, UP, qb, Oz, ti, dT, My;
bh: gg, xA, Yg, Ti;
Uj: re, DE, oJ, JM;
My: Ym, WB, na, Jv, Yy, tD, pL, zI;
Zd: hx, zI, Oh, CB, gg, yz, th, QX, YQ, My;
UP: hx, Ym, AG, na, SO, YQ, YW;
SF: dO, gg, Jv, DC, Yg, uM, dT;
Zx: KS, HY, Xm, DE, Yy, yz, Oz, PJ;
bQ: na, Xa, aL;
wQ: rU, xe, qv;
bS: DL, NL, DE, bh, DC, re, hH, bQ, sF, pL;
Zu: vQ, Jh;
ou: xA, rQ, wQ;
xe: Ss, Bk;
FC: Xm, kI, Xa, aL, fe, Vw;
pL: KA, LR, Xm;
NJ: qb, sF, Oh;
NL: oJ, Xm, CB, Xa, LR, tK, bS, SF;
xA: tD, HY, aL, pL, WB;
Yg: AG, zj, qv, FC, wQ, dT;
NW: Yy, Zu, Xa;
hx: Dn, Ym, qb, Ti, Zu, My, Xw, he;
Ss: DN, Om, DL;
CB: dO, Ym, lN, bh, SJ, fh, ou, pL, NW;
uM: vQ, Zx, sF;
uK: Jh, Ti;
hf: Dn, kf, Xa, UP, uM, Gf, mp, wQ;
XT: Oh, Yy, YQ, bS, fh, he;
he: dO, HY, wQ, ed, FC, th, XT;
KA: KS, zI, Xw, vQ, fo;
Xm: DN, gT, kf, QX, DC, TP, aL, KS, fe, fh;
Xa: dO, JM, vQ, qb, Oz, dT, mp;
KS: QX, qb;
SJ: KS, re;
hH: dO, yk, qv, Jv, UP, sF, tK, uK, Xw, DL;
SO: rU, Om, Oh, na, DC, TP, qb, PJ, ug, he;
mp: WB, zj, re, Ss, xe, vQ, LU, bQ, bS;
ug: Xm, bh, aL, Yg, KS, SO, Uj, tD;
Xw: Af, Zd, QX, UP, Yg, SJ, ou;
DN: Ss, rU, qb, th;
DL: AG, Ti, aL, qb, Vw, ug;
DE: kf, CB, vQ, wQ, tD, SF, pL, he;
DC: yk, LR, fe, Ti, SO, ug, pL;
Ti: dO, SJ, Zd, ed, bh, Gf, qb, hf, My;
YQ: Om, oJ, Af, qb, Jh, dT, SF;
id: lN, HY, xe, th, ti;
YW: KA, HY, AG, Jv, gg, LR, wQ, Vw;
Dn: DN, dO, DL, oJ, Oh, Ss, re, LR, fh;
Ym: dO, NL, zI, kI, Xa, Yy, qb, uK, My;
na: hx, Gf, hH, FC, SO, ou, My, SF, pL;
aL: Af, Oh, ed, Jv, DE, uM, Zx, uK, bS, Zu;
TP: Dn, dT;
Yy: ed, gg, vQ, GA, QX, sB;
vQ: QX, Jh;
LU: Dn, oJ, Zd, gg, id, XT;
LR: DN, Ym, oJ, aL, gg, hH, Oz, bS, iE, sF;
iE: FC, Zx, th;
AG: KA, zI, xA, Gf, yz, bS, id, YW, rQ;
kI: Oz, tK;
fe: lN, Ss;
fh: Yy, ou, My, uK;
sB: rU, kf, ed, LR, bQ, bS, SF, pL;
sF: SJ, YW;
fo: Ss, bS;
kf: lN, bh, UP;
Af: Dn, WB, CB, gg, Vw, fh, sB, Xw, fo;
QX: Dn, SF, SJ, ug, hf, sF, he;
Vw: Af, HY, qv, Yg, he;