test_100_8 {}

WE: GO, KH, UH, yt, Rs;
tZ: NH, Sy, TL, sn, jJ, fo, ri, oP;
Rs: NH, LW;
BI: Sy, LW, WE, MJ, Lw, fE, jJ, jS, wz;
Re: NH, YF, LW, As, PG, Yp, UR, ZP;
le: pu, Fx, xx, Lw, As, qF, SB, fo, rh, ly;
Jg: GO, It, pd, hm;
ly: WE, le, tZ, ri;
qP: QS, VF, It, xd, YF, Pl;
dl: hz, YK, pu, KH, Qb, qF, Ud, by, fo;
Oj: Vp, Nj, KG, Cu;
yb: Do, TL, hw, xd, As, GA, ri, mZ;
yf: hz, QS;
GA: As, pF, PG, qF, SB, mZ;
qF: hz, em, mc, qP, Rs, dC, fo;
GO: mc, pu, jS, Re, Tg, ja, yt, fo;
yt: SB, Yp;
dC: NH, Do, jC, pd, Re;
Gy: dl, It, Pb, GA, Mr, Ud, ja, Cu, mZ;
jS: Vp;
Gd: nO, kL, Tg, MJ, rh, ri;
em: KG, hw, BI, MJ, It, Cu;
Pb: Fx, QS, jC;
zx: Do, QS, Nd, UH, Rs;
rB: nH, Ts, Gy, Vp, Re, fE, fo;
dA: BI, qF;
Pl: sZ, Sy, TT, dl, SN, Ud, ZP, yt, WE;
by: BI, QN;
eB: ae, qF, BI, jS, pF, sn, Mr, kL, ja, oP;
PG: Do, Lw, jS;
rh: Do, nO, Gy, dA, LW, fo, ly, wz, QN;
ri: Nj, le, YF, iI, Qb, sn, Mr, wz, Cu;
eR: dl, Nd, BI, zx, GA, Cu;
ba: iI, Qb, Mi, eB, MJ;
Mi: TL, ri, ba;
Mr: ba, nO, Gy, pd, eR, by, mZ;
Ud: sZ, dl, Mi, Nd, As, mZ;
oT: qP, Sy, KH, Ts, yf, SN;
ZP: Do, YK, sZ, CI, wz, wS, yt, QN;
wz: Vp, yb, oP;
oP: iY, Sy, dl, xx, eR;
UR: VF, Rs, KH, jS, kL, UH, GO, fo, ri, eR;
MV: Nj, Mi, kL, zx, rB, ja;
wS: Yp, WE, Rs, Gy, qF;
UH: As, KG, hw, Pl;
jJ: hz, Sy, ae, Oj, As, Qb, pd;
jC: sZ, pu, TK, Cu, Mr;
Nj: YK, Rs, Lw, xx, PG, Yp, rh, ly;
Nd: em, qP, Sy, tZ, zx, KG, eR, QN;
xd: em, MV;
xx: nH, Do, yf, LW, TL, TK, Yp, yt, QN;
pF: VF, Mi, MJ, sn, Jg, mZ;
NH: WE, rh, ja, hm;
pu: CI, KG, jS, ZP, wz, jC;
Fx: Sy, le, tZ, ja;
xC: Vp, by;
ja: PG, Rs, xd, Lw, SN, rB, hm, oP;
pd: qP, KG, It, iI, LW, Mr, Ud;
hz: sZ, Fx, Mi, BI, wS, UH, fo;
Sy: Vp, Lw, ba, TK, dA;
hw: le, fE, Cu;
hm: Ts, It;
mZ: TK, eB;
KG: Sy, pu, eB, mZ, Jg, by, oP, jC;
mc: Nj, KH, MJ, xx, SN, GO;
KH: Ud, ae, sZ;
SN: nH, qP, yb, Gy, kL, SB, eR;
SB: hz, yb, jJ;
Cu: Fx, MJ, ZP, Oj, eR;
nH: Pb, BI;
YK: WE, tZ, nO, BI, jS, eR;
ae: sZ, TL, MV, fE;
nO: iI, Sy, sn, Rs;
Ts: QS, ba, VF, TT, UR, UH, hm, Jg;
YF: ae, hw, Gy, kL, qF, ja;
Lw: yb, It, iI, wS, pd, ZP, by;
Tg: WE, TT, Mi, kL, TL, Gd, oT, wz;
MJ: iI, Do, PG;
iY: sZ, YK, Mi, It, Pb, Lw, xx;
Do: fE, ly;
TT: YK, VF, Gy, rB, oP, eR;
iI: dl, MV, yf;
LW: qP, YK, nO, Qb, GA, Yp, Cu, QN;
TL: KH, UH;
TK: hz, yb, UH;
Yp: em, Do, ae, As, wS, pF, oP, rh, mZ;
sn: iI, hz, xx, Sy, kL;
sZ: nH, Ts, MV, rh, Qb, QN;
VF: CI, ae, Oj, Rs, WE, UH, jJ;
kL: sZ, mZ, hm, ja, Mr;
Qb: WE, oT, Nj, Rs;
fo: NH, le, jS, pF, PG, Tg, SB, ZP;
QS: iY, mc, pu, yb, eB, Re, yt, ly;
CI: tZ, TT, Nd, dA, jS, wz;
It: CI, Mi, BI, mc, jS;
Vp: Nj, oT, mc, KH, BI, dC, Gd, Jg, ZP;
As: qP, MJ, hm;
fE: em, WE, ae, nO, TT, dl, Gy;
QN: hz, sZ, KG, ba, Mi, wS, SN, pd, qF, UH;