test_100_4 {}

BD: eM, XO, Wo, iU, WU, Jn, yP, AY, Ax, pl;
gq: cW, WU, Zx, MP, MS, yP, dr, rj;
iU: PJ, yk, Nm;
lK: kc, DI, eB, Hh, JI, MS, TD, Dr, pl;
WU: ck, pd, Dx, gq, Ev, Wo, cx, vv, vY, zw;
BP: eM, va, ka, aM, Ea, MH, Dx, Sb;
JI: cW, Nc, HU, Ia, TD, Ns, dr, PM;
JJ: va, qr, co, Ea, Hv, PI;
gm: Tg, Ev, XO;
Ro: AY, be, KA, zw, iU;
Wo: BD, SX, kd, Ks, cx, JI, pd, ud, dT;
Jn: Hh, RF, Ro, MP, eJ;
lO: eM, BD;
yk: va, SX, eJ, eB, Kv, Sb, vY, Ro;
qB: sR, cx, aM, ud;
dr: sR, FN;
qr: BD, be, Hl, PX, eB, JI, JJ, qk;
yP: KA, gq, Ea, Tg, Ax, zw;
dT: zj, sR, cx, pd, yP, qk, Ev, FN;
Gh: eM, va, eJ, MH, IT, AY, vY, dT, Ev;
zj: SX, kd, NB, DI, lK, MP, oW, dT, FN;
Pu: ka, zj, eJ, LK, av, Ax, Ro, pl;
HU: Wo, PJ, PX, Dx;
HJ: BD, va, Nm, eJ, Nc, LS, Ax, Ns, nT, FN;
zw: VS, co, MS;
eM: ck, Dx, Kv, pd, PJ, ud, cW, PM;
eJ: yP, Pu;
PX: ka, Nm, UU, iU, HJ, BP;
Hv: co, zj, Wo, LK, hN, Kv, JJ, dr;
eB: hB, BD, NB, MH, Pu;
Hh: Ks, gq;
Hl: ud, cx, Gh;
PJ: ck, Jn, LK, gq, Gh;
PI: kc, HJ, DI, UU, PX, Qv, Ks, dT;
rj: BD, aM, Hh, pd, PJ, gm, Ro, Gh;
PM: be, qr, kd, eB, mw, MP, AY, PI, Dr;
be: va, nT, PM;
oW: BD, KA, co, cx, LS, Dx, TD, PI;
qk: qr, NB, mK, eB, RF, cx, Hl, av, dr;
UU: SX, aM, lK, LK, hB, Hh, Zx, MS, oW, Ro;
Ea: HJ, yk;
MH: XO, eJ, Wo, PX, Hv, LK, UU, ud, qk, Ns;
Zx: Wo, yP, qk, Ro, dr;
MP: Ks, gq, HJ, RF, fd, pd, Ax, BP, PM;
MS: KA, NB, ka, yk, rj, AY, ud, FN;
Ev: ud, RF, nT, av;
ck: Ia, Pu;
co: sR, TD, Tg;
Nm: kc, va, eJ, WU, oW, TD, CQ, FN;
No: NB, Ro, Jn, Nm;
Nc: be, kd, lO, Hv, IT, MH, MS, Ns, pl;
cx: Hh, Jn, Kv, Dx, Ax, dr, PM;
Ns: va, NB, SX, BP;
FN: No, WU, RF, Tg, Ns, nT;
NB: qr, Hl, HJ, fd, vv, av;
RF: Wo, PX, Dx;
pd: hN, Ro, aM, zj;
cW: MS, Pu;
pl: ka, MS, Qv, kd, lK, cx, pd, Ia, gm;
XO: sR, lO, qB, cW, TD, dr;
mK: UU, iU, Ax, hN, JJ, Tg, AY, ud, dr;
Ks: BD, No, aM, BP, JI, av, Ax, qk;
Kv: PX, Nc, Hv, IT, MP, Sb, Ax;
Sb: HJ, dT, Hl;
CQ: XO, UU, RF, mw, hN, vv, Dr;
KA: BD, va, yk, co, Qv, PX, AY, Hh, Ia;
SX: DI, Qv, eB, pd, Ns, cW, pl;
mw: fd, iU, Hl, MS, DI;
hN: zj, NB, Ea, Jn, eB, Hh, Hl;
hB: AY, JI, Hl, PJ, TD, FN;
ud: dT, hN;
va: be, PI, qr;
DI: eM, ka, Ns, Hv, JJ;
vv: pd, Dx, lK, Hl, JJ, ud, zw, Dr;
av: RF, Zx, LS, ud, BP, CQ, pl;
Tg: BD, Dx, Nc, iU, mK, qB, vv, Ax, cW;
nT: gq, kd, Wo, RF, WU, VS, hN, Dr, rj;
aM: BD, HJ, eM, BP, mK;
LK: Nm, eJ, No, av, ud, TD, dT;
LS: Qv, UU, RF, JJ, Ns, Dr, FN;
Dx: Tg, PI, zw, hN;
vY: XO, Dr, MH, lK, oW, qk, HU, dr;
TD: va, ka, Nm, lK, mK, hB, Hl, AY, Ns;
Dr: ka, MP;
Qv: yk, PX, Jn, RF, VS, BP, vv, PJ, CQ;
sR: Ns, cW;
IT: co, XO, DI, aM, lK, WU, Dx, zw, Nm;
VS: Ks, MS, vv;
fd: ud, Hh, rj;
AY: be, KA, XO, Wo, MP, pd, yP, Tg, Ns;
kc: eJ, VS, Dx, Sb, dT, Ns;
ka: Hl, zj;
kd: BD, cx;
Ia: Nc, LK, HJ, Ev, FN, Gh;
Ax: Jn, qB, Dr, kd;